eQTL_eQTLGen	/storage/yangjianLab/guoyazhou/new/QTL_data/QTL_clumping/total/eQTLGen_clumped.cojo
eQTL_BrainMeta	/storage/yangjianLab/guoyazhou/new/QTL_data/QTL_clumping/total/eQTL_BrainMeta_clumped.cojo
eQTL_GTEx_Adipose_Subcutaneous	/storage/yangjianLab/guoyazhou/new/QTL_data/QTL_clumping/total/eQTL_GTEx_Adipose_Subcutaneous_clumped.cojo
eQTL_GTEx_Adipose_Visceral_Omentum	/storage/yangjianLab/guoyazhou/new/QTL_data/QTL_clumping/total/eQTL_GTEx_Adipose_Visceral_Omentum_clumped.cojo
eQTL_GTEx_Adrenal_Gland	/storage/yangjianLab/guoyazhou/new/QTL_data/QTL_clumping/total/eQTL_GTEx_Adrenal_Gland_clumped.cojo
eQTL_GTEx_Artery_Aorta	/storage/yangjianLab/guoyazhou/new/QTL_data/QTL_clumping/total/eQTL_GTEx_Artery_Aorta_clumped.cojo
eQTL_GTEx_Artery_Coronary	/storage/yangjianLab/guoyazhou/new/QTL_data/QTL_clumping/total/eQTL_GTEx_Artery_Coronary_clumped.cojo
eQTL_GTEx_Artery_Tibial	/storage/yangjianLab/guoyazhou/new/QTL_data/QTL_clumping/total/eQTL_GTEx_Artery_Tibial_clumped.cojo
eQTL_GTEx_Brain_Amygdala	/storage/yangjianLab/guoyazhou/new/QTL_data/QTL_clumping/total/eQTL_GTEx_Brain_Amygdala_clumped.cojo
eQTL_GTEx_Brain_Anterior_cingulate_cortex_BA24	/storage/yangjianLab/guoyazhou/new/QTL_data/QTL_clumping/total/eQTL_GTEx_Brain_Anterior_cingulate_cortex_BA24_clumped.cojo
eQTL_GTEx_Brain_Caudate_basal_ganglia	/storage/yangjianLab/guoyazhou/new/QTL_data/QTL_clumping/total/eQTL_GTEx_Brain_Caudate_basal_ganglia_clumped.cojo
eQTL_GTEx_Brain_Cerebellar_Hemisphere	/storage/yangjianLab/guoyazhou/new/QTL_data/QTL_clumping/total/eQTL_GTEx_Brain_Cerebellar_Hemisphere_clumped.cojo
eQTL_GTEx_Brain_Cerebellum	/storage/yangjianLab/guoyazhou/new/QTL_data/QTL_clumping/total/eQTL_GTEx_Brain_Cerebellum_clumped.cojo
eQTL_GTEx_Brain_Cortex	/storage/yangjianLab/guoyazhou/new/QTL_data/QTL_clumping/total/eQTL_GTEx_Brain_Cortex_clumped.cojo
eQTL_GTEx_Brain_Frontal_Cortex_BA9	/storage/yangjianLab/guoyazhou/new/QTL_data/QTL_clumping/total/eQTL_GTEx_Brain_Frontal_Cortex_BA9_clumped.cojo
eQTL_GTEx_Brain_Hippocampus	/storage/yangjianLab/guoyazhou/new/QTL_data/QTL_clumping/total/eQTL_GTEx_Brain_Hippocampus_clumped.cojo
eQTL_GTEx_Brain_Hypothalamus	/storage/yangjianLab/guoyazhou/new/QTL_data/QTL_clumping/total/eQTL_GTEx_Brain_Hypothalamus_clumped.cojo
eQTL_GTEx_Brain_Nucleus_accumbens_basal_ganglia	/storage/yangjianLab/guoyazhou/new/QTL_data/QTL_clumping/total/eQTL_GTEx_Brain_Nucleus_accumbens_basal_ganglia_clumped.cojo
eQTL_GTEx_Brain_Putamen_basal_ganglia	/storage/yangjianLab/guoyazhou/new/QTL_data/QTL_clumping/total/eQTL_GTEx_Brain_Putamen_basal_ganglia_clumped.cojo
eQTL_GTEx_Brain_Spinal_cord_cervical_c-1	/storage/yangjianLab/guoyazhou/new/QTL_data/QTL_clumping/total/eQTL_GTEx_Brain_Spinal_cord_cervical_c-1_clumped.cojo
eQTL_GTEx_Brain_Substantia_nigra	/storage/yangjianLab/guoyazhou/new/QTL_data/QTL_clumping/total/eQTL_GTEx_Brain_Substantia_nigra_clumped.cojo
eQTL_GTEx_Breast_Mammary_Tissue	/storage/yangjianLab/guoyazhou/new/QTL_data/QTL_clumping/total/eQTL_GTEx_Breast_Mammary_Tissue_clumped.cojo
eQTL_GTEx_Cells_Cultured_fibroblasts	/storage/yangjianLab/guoyazhou/new/QTL_data/QTL_clumping/total/eQTL_GTEx_Cells_Cultured_fibroblasts_clumped.cojo
eQTL_GTEx_Cells_EBV-transformed_lymphocytes	/storage/yangjianLab/guoyazhou/new/QTL_data/QTL_clumping/total/eQTL_GTEx_Cells_EBV-transformed_lymphocytes_clumped.cojo
eQTL_GTEx_Colon_Sigmoid	/storage/yangjianLab/guoyazhou/new/QTL_data/QTL_clumping/total/eQTL_GTEx_Colon_Sigmoid_clumped.cojo
eQTL_GTEx_Colon_Transverse	/storage/yangjianLab/guoyazhou/new/QTL_data/QTL_clumping/total/eQTL_GTEx_Colon_Transverse_clumped.cojo
eQTL_GTEx_Esophagus_Gastroesophageal_Junction	/storage/yangjianLab/guoyazhou/new/QTL_data/QTL_clumping/total/eQTL_GTEx_Esophagus_Gastroesophageal_Junction_clumped.cojo
eQTL_GTEx_Esophagus_Mucosa	/storage/yangjianLab/guoyazhou/new/QTL_data/QTL_clumping/total/eQTL_GTEx_Esophagus_Mucosa_clumped.cojo
eQTL_GTEx_Esophagus_Muscularis	/storage/yangjianLab/guoyazhou/new/QTL_data/QTL_clumping/total/eQTL_GTEx_Esophagus_Muscularis_clumped.cojo
eQTL_GTEx_Heart_Atrial_Appendage	/storage/yangjianLab/guoyazhou/new/QTL_data/QTL_clumping/total/eQTL_GTEx_Heart_Atrial_Appendage_clumped.cojo
eQTL_GTEx_Heart_Left_Ventricle	/storage/yangjianLab/guoyazhou/new/QTL_data/QTL_clumping/total/eQTL_GTEx_Heart_Left_Ventricle_clumped.cojo
eQTL_GTEx_Kidney_Cortex	/storage/yangjianLab/guoyazhou/new/QTL_data/QTL_clumping/total/eQTL_GTEx_Kidney_Cortex_clumped.cojo
eQTL_GTEx_Liver	/storage/yangjianLab/guoyazhou/new/QTL_data/QTL_clumping/total/eQTL_GTEx_Liver_clumped.cojo
eQTL_GTEx_Lung	/storage/yangjianLab/guoyazhou/new/QTL_data/QTL_clumping/total/eQTL_GTEx_Lung_clumped.cojo
eQTL_GTEx_Minor_Salivary_Gland	/storage/yangjianLab/guoyazhou/new/QTL_data/QTL_clumping/total/eQTL_GTEx_Minor_Salivary_Gland_clumped.cojo
eQTL_GTEx_Muscle_Skeletal	/storage/yangjianLab/guoyazhou/new/QTL_data/QTL_clumping/total/eQTL_GTEx_Muscle_Skeletal_clumped.cojo
eQTL_GTEx_Nerve_Tibial	/storage/yangjianLab/guoyazhou/new/QTL_data/QTL_clumping/total/eQTL_GTEx_Nerve_Tibial_clumped.cojo
eQTL_GTEx_Ovary	/storage/yangjianLab/guoyazhou/new/QTL_data/QTL_clumping/total/eQTL_GTEx_Ovary_clumped.cojo
eQTL_GTEx_Pancreas	/storage/yangjianLab/guoyazhou/new/QTL_data/QTL_clumping/total/eQTL_GTEx_Pancreas_clumped.cojo
eQTL_GTEx_Pituitary	/storage/yangjianLab/guoyazhou/new/QTL_data/QTL_clumping/total/eQTL_GTEx_Pituitary_clumped.cojo
eQTL_GTEx_Prostate	/storage/yangjianLab/guoyazhou/new/QTL_data/QTL_clumping/total/eQTL_GTEx_Prostate_clumped.cojo
eQTL_GTEx_Skin_Not_Sun_Exposed_Suprapubic	/storage/yangjianLab/guoyazhou/new/QTL_data/QTL_clumping/total/eQTL_GTEx_Skin_Not_Sun_Exposed_Suprapubic_clumped.cojo
eQTL_GTEx_Skin_Sun_Exposed_Lower_leg	/storage/yangjianLab/guoyazhou/new/QTL_data/QTL_clumping/total/eQTL_GTEx_Skin_Sun_Exposed_Lower_leg_clumped.cojo
eQTL_GTEx_Small_Intestine_Terminal_Ileum	/storage/yangjianLab/guoyazhou/new/QTL_data/QTL_clumping/total/eQTL_GTEx_Small_Intestine_Terminal_Ileum_clumped.cojo
eQTL_GTEx_Spleen	/storage/yangjianLab/guoyazhou/new/QTL_data/QTL_clumping/total/eQTL_GTEx_Spleen_clumped.cojo
eQTL_GTEx_Stomach	/storage/yangjianLab/guoyazhou/new/QTL_data/QTL_clumping/total/eQTL_GTEx_Stomach_clumped.cojo
eQTL_GTEx_Testis	/storage/yangjianLab/guoyazhou/new/QTL_data/QTL_clumping/total/eQTL_GTEx_Testis_clumped.cojo
eQTL_GTEx_Thyroid	/storage/yangjianLab/guoyazhou/new/QTL_data/QTL_clumping/total/eQTL_GTEx_Thyroid_clumped.cojo
eQTL_GTEx_Uterus	/storage/yangjianLab/guoyazhou/new/QTL_data/QTL_clumping/total/eQTL_GTEx_Uterus_clumped.cojo
eQTL_GTEx_Vagina	/storage/yangjianLab/guoyazhou/new/QTL_data/QTL_clumping/total/eQTL_GTEx_Vagina_clumped.cojo
eQTL_GTEx_Whole_Blood	/storage/yangjianLab/guoyazhou/new/QTL_data/QTL_clumping/total/eQTL_GTEx_Whole_Blood_clumped.cojo
sQTL_BrainMeta	/storage/yangjianLab/guoyazhou/new/QTL_data/QTL_clumping/total/sQTL_BrainMeta_clumped.cojo
sQTL_GTEx_Adipose_Subcutaneous	/storage/yangjianLab/guoyazhou/new/QTL_data/QTL_clumping/total/sQTL_GTEx_Adipose_Subcutaneous_clumped.cojo
sQTL_GTEx_Adipose_Visceral_Omentum	/storage/yangjianLab/guoyazhou/new/QTL_data/QTL_clumping/total/sQTL_GTEx_Adipose_Visceral_Omentum_clumped.cojo
sQTL_GTEx_Adrenal_Gland	/storage/yangjianLab/guoyazhou/new/QTL_data/QTL_clumping/total/sQTL_GTEx_Adrenal_Gland_clumped.cojo
sQTL_GTEx_Artery_Aorta	/storage/yangjianLab/guoyazhou/new/QTL_data/QTL_clumping/total/sQTL_GTEx_Artery_Aorta_clumped.cojo
sQTL_GTEx_Artery_Coronary	/storage/yangjianLab/guoyazhou/new/QTL_data/QTL_clumping/total/sQTL_GTEx_Artery_Coronary_clumped.cojo
sQTL_GTEx_Artery_Tibial	/storage/yangjianLab/guoyazhou/new/QTL_data/QTL_clumping/total/sQTL_GTEx_Artery_Tibial_clumped.cojo
sQTL_GTEx_Brain_Amygdala	/storage/yangjianLab/guoyazhou/new/QTL_data/QTL_clumping/total/sQTL_GTEx_Brain_Amygdala_clumped.cojo
sQTL_GTEx_Brain_Anterior_cingulate_cortex_BA24	/storage/yangjianLab/guoyazhou/new/QTL_data/QTL_clumping/total/sQTL_GTEx_Brain_Anterior_cingulate_cortex_BA24_clumped.cojo
sQTL_GTEx_Brain_Caudate_basal_ganglia	/storage/yangjianLab/guoyazhou/new/QTL_data/QTL_clumping/total/sQTL_GTEx_Brain_Caudate_basal_ganglia_clumped.cojo
sQTL_GTEx_Brain_Cerebellar_Hemisphere	/storage/yangjianLab/guoyazhou/new/QTL_data/QTL_clumping/total/sQTL_GTEx_Brain_Cerebellar_Hemisphere_clumped.cojo
sQTL_GTEx_Brain_Cerebellum	/storage/yangjianLab/guoyazhou/new/QTL_data/QTL_clumping/total/sQTL_GTEx_Brain_Cerebellum_clumped.cojo
sQTL_GTEx_Brain_Cortex	/storage/yangjianLab/guoyazhou/new/QTL_data/QTL_clumping/total/sQTL_GTEx_Brain_Cortex_clumped.cojo
sQTL_GTEx_Brain_Frontal_Cortex_BA9	/storage/yangjianLab/guoyazhou/new/QTL_data/QTL_clumping/total/sQTL_GTEx_Brain_Frontal_Cortex_BA9_clumped.cojo
sQTL_GTEx_Brain_Hippocampus	/storage/yangjianLab/guoyazhou/new/QTL_data/QTL_clumping/total/sQTL_GTEx_Brain_Hippocampus_clumped.cojo
sQTL_GTEx_Brain_Hypothalamus	/storage/yangjianLab/guoyazhou/new/QTL_data/QTL_clumping/total/sQTL_GTEx_Brain_Hypothalamus_clumped.cojo
sQTL_GTEx_Brain_Nucleus_accumbens_basal_ganglia	/storage/yangjianLab/guoyazhou/new/QTL_data/QTL_clumping/total/sQTL_GTEx_Brain_Nucleus_accumbens_basal_ganglia_clumped.cojo
sQTL_GTEx_Brain_Putamen_basal_ganglia	/storage/yangjianLab/guoyazhou/new/QTL_data/QTL_clumping/total/sQTL_GTEx_Brain_Putamen_basal_ganglia_clumped.cojo
sQTL_GTEx_Brain_Spinal_cord_cervical_c-1	/storage/yangjianLab/guoyazhou/new/QTL_data/QTL_clumping/total/sQTL_GTEx_Brain_Spinal_cord_cervical_c-1_clumped.cojo
sQTL_GTEx_Brain_Substantia_nigra	/storage/yangjianLab/guoyazhou/new/QTL_data/QTL_clumping/total/sQTL_GTEx_Brain_Substantia_nigra_clumped.cojo
sQTL_GTEx_Breast_Mammary_Tissue	/storage/yangjianLab/guoyazhou/new/QTL_data/QTL_clumping/total/sQTL_GTEx_Breast_Mammary_Tissue_clumped.cojo
sQTL_GTEx_Cells_Cultured_fibroblasts	/storage/yangjianLab/guoyazhou/new/QTL_data/QTL_clumping/total/sQTL_GTEx_Cells_Cultured_fibroblasts_clumped.cojo
sQTL_GTEx_Cells_EBV-transformed_lymphocytes	/storage/yangjianLab/guoyazhou/new/QTL_data/QTL_clumping/total/sQTL_GTEx_Cells_EBV-transformed_lymphocytes_clumped.cojo
sQTL_GTEx_Colon_Sigmoid	/storage/yangjianLab/guoyazhou/new/QTL_data/QTL_clumping/total/sQTL_GTEx_Colon_Sigmoid_clumped.cojo
sQTL_GTEx_Colon_Transverse	/storage/yangjianLab/guoyazhou/new/QTL_data/QTL_clumping/total/sQTL_GTEx_Colon_Transverse_clumped.cojo
sQTL_GTEx_Esophagus_Gastroesophageal_Junction	/storage/yangjianLab/guoyazhou/new/QTL_data/QTL_clumping/total/sQTL_GTEx_Esophagus_Gastroesophageal_Junction_clumped.cojo
sQTL_GTEx_Esophagus_Mucosa	/storage/yangjianLab/guoyazhou/new/QTL_data/QTL_clumping/total/sQTL_GTEx_Esophagus_Mucosa_clumped.cojo
sQTL_GTEx_Esophagus_Muscularis	/storage/yangjianLab/guoyazhou/new/QTL_data/QTL_clumping/total/sQTL_GTEx_Esophagus_Muscularis_clumped.cojo
sQTL_GTEx_Heart_Atrial_Appendage	/storage/yangjianLab/guoyazhou/new/QTL_data/QTL_clumping/total/sQTL_GTEx_Heart_Atrial_Appendage_clumped.cojo
sQTL_GTEx_Heart_Left_Ventricle	/storage/yangjianLab/guoyazhou/new/QTL_data/QTL_clumping/total/sQTL_GTEx_Heart_Left_Ventricle_clumped.cojo
sQTL_GTEx_Kidney_Cortex	/storage/yangjianLab/guoyazhou/new/QTL_data/QTL_clumping/total/sQTL_GTEx_Kidney_Cortex_clumped.cojo
sQTL_GTEx_Liver	/storage/yangjianLab/guoyazhou/new/QTL_data/QTL_clumping/total/sQTL_GTEx_Liver_clumped.cojo
sQTL_GTEx_Lung	/storage/yangjianLab/guoyazhou/new/QTL_data/QTL_clumping/total/sQTL_GTEx_Lung_clumped.cojo
sQTL_GTEx_Minor_Salivary_Gland	/storage/yangjianLab/guoyazhou/new/QTL_data/QTL_clumping/total/sQTL_GTEx_Minor_Salivary_Gland_clumped.cojo
sQTL_GTEx_Muscle_Skeletal	/storage/yangjianLab/guoyazhou/new/QTL_data/QTL_clumping/total/sQTL_GTEx_Muscle_Skeletal_clumped.cojo
sQTL_GTEx_Nerve_Tibial	/storage/yangjianLab/guoyazhou/new/QTL_data/QTL_clumping/total/sQTL_GTEx_Nerve_Tibial_clumped.cojo
sQTL_GTEx_Ovary	/storage/yangjianLab/guoyazhou/new/QTL_data/QTL_clumping/total/sQTL_GTEx_Ovary_clumped.cojo
sQTL_GTEx_Pancreas	/storage/yangjianLab/guoyazhou/new/QTL_data/QTL_clumping/total/sQTL_GTEx_Pancreas_clumped.cojo
sQTL_GTEx_Pituitary	/storage/yangjianLab/guoyazhou/new/QTL_data/QTL_clumping/total/sQTL_GTEx_Pituitary_clumped.cojo
sQTL_GTEx_Prostate	/storage/yangjianLab/guoyazhou/new/QTL_data/QTL_clumping/total/sQTL_GTEx_Prostate_clumped.cojo
sQTL_GTEx_Skin_Not_Sun_Exposed_Suprapubic	/storage/yangjianLab/guoyazhou/new/QTL_data/QTL_clumping/total/sQTL_GTEx_Skin_Not_Sun_Exposed_Suprapubic_clumped.cojo
sQTL_GTEx_Skin_Sun_Exposed_Lower_leg	/storage/yangjianLab/guoyazhou/new/QTL_data/QTL_clumping/total/sQTL_GTEx_Skin_Sun_Exposed_Lower_leg_clumped.cojo
sQTL_GTEx_Small_Intestine_Terminal_Ileum	/storage/yangjianLab/guoyazhou/new/QTL_data/QTL_clumping/total/sQTL_GTEx_Small_Intestine_Terminal_Ileum_clumped.cojo
sQTL_GTEx_Spleen	/storage/yangjianLab/guoyazhou/new/QTL_data/QTL_clumping/total/sQTL_GTEx_Spleen_clumped.cojo
sQTL_GTEx_Stomach	/storage/yangjianLab/guoyazhou/new/QTL_data/QTL_clumping/total/sQTL_GTEx_Stomach_clumped.cojo
sQTL_GTEx_Testis	/storage/yangjianLab/guoyazhou/new/QTL_data/QTL_clumping/total/sQTL_GTEx_Testis_clumped.cojo
sQTL_GTEx_Thyroid	/storage/yangjianLab/guoyazhou/new/QTL_data/QTL_clumping/total/sQTL_GTEx_Thyroid_clumped.cojo
sQTL_GTEx_Uterus	/storage/yangjianLab/guoyazhou/new/QTL_data/QTL_clumping/total/sQTL_GTEx_Uterus_clumped.cojo
sQTL_GTEx_Vagina	/storage/yangjianLab/guoyazhou/new/QTL_data/QTL_clumping/total/sQTL_GTEx_Vagina_clumped.cojo
sQTL_GTEx_Whole_Blood	/storage/yangjianLab/guoyazhou/new/QTL_data/QTL_clumping/total/sQTL_GTEx_Whole_Blood_clumped.cojo
pQTL_FENLAND	/storage/yangjianLab/guoyazhou/new/QTL_data/QTL_clumping/total/pQTL_FENLAND_clumped.cojo
pQTL_SCALLOP	/storage/yangjianLab/guoyazhou/new/QTL_data/QTL_clumping/total/pQTL_SCALLOP_clumped.cojo
pQTL_INTERVAL	/storage/yangjianLab/guoyazhou/new/QTL_data/QTL_clumping/total/pQTL_INTERVAL_clumped.cojo
mQTL_BrainMeta	/storage/yangjianLab/guoyazhou/new/QTL_data/QTL_clumping/total/mQTL_BrainMeta_clumped.cojo
mQTL_McRae	/storage/yangjianLab/guoyazhou/new/QTL_data/QTL_clumping/total/mQTL_McRae_clumped.cojo
